16 16 16 16 16 16 16 16 16 16 16 16 16 16 16 16 16 16 16 16 16 16 16 16 16 16 16 16 16 16 16 16 16 16 16 16 16 16 16 16 16 16 16 16 16 16 16 16 16 16
16 16 16 16 16 16 16 16 16 16 16 16 16 16 16 16 16 16 16 16 2 19 19 19 19 19 2 16 16 16 16 16 16 16 16 16 16 16 16 16 16 16 16 16 16 16
16 16 16 16 16 16 16 16 16 16 16 16 16 16 16 16 16 16 16 16 2 19 19 19 19 19 2 16 16 16 16 16 16 16 16 16 16 16 16 16 16 16 16 16 16 16
16 16 16 16 16 16 16 16 16 16 16 16 16 16 16 16 16 16 16 16 19 19 19 19 19 19 19 16 16 16 16 16 16 16 16 16 16 16 16 16 16 16 16 16 16 16
16 16 16 16 16 16 16 16 16 16 16 16 16 16 16 16 16 16 16 16 19 19 19 19 19 19 19 16 16 16 16 16 16 16 16 16 16 16 16 16 16 16 16 16 16 16
16 16 16 16 16 16 16 16 16 16 16 16 16 16 16 16 16 16 16 16 19 19 19 19 19 19 19 16 16 16 16 16 16 16 16 16 16 16 16 16 16 16 16 16 16 16
16 16 16 16 16 16 16 16 32 32 32 32 32 16 16 16 16 16 16 16 16 19 19 19 19 19 16 16 16 16 16 16 16 16 16 16 16 16 16 16 16 16 16 16 16 16 16 16 16
16 16 16 16 16 16 16 16 32 3 3 3 32 16 16 16 16 16 16 16 2 2 2 3 2 2 2 16 16 16 16 16 16 2 3 3 3 3 3 3 3 16 16 16 16 16 16 16 16 16
16 16 16 16 16 16 16 16 32 3 3 3 32 16 16 16 16 16 16 16 16 2 2 2 2 2 16 16 16 16 16 16 16 16 3 3 3 3 3 3 3 3 16 16 16 16 16 16 16 16
16 16 16 16 16 16 16 16 32 3 3 3 32 16 16 16 16 16 16 16 16 16 2 2 2 16 16 16 16 16 16 16 16 16 3 3 3 3 3 3 3 3 16 16 16 16 16 16 16 16
16 16 16 16 16 16 16 16 32 3 3 3 32 16 16 16 16 16 16 16 16 16 16 3 16 16 16 16 16 16 16 16 16 16 3 3 3 3 3 3 3 3 16 16 16 16 16 16 16 16
16 16 16 16 16 16 16 16 32 32 2 32 32 16 16 16 16 16 16 16 16 16 16 3 16 16 16 16 16 16 16 16 16 16 3 3 3 3 3 3 3 3 16 16 16 16 16 16 16 16
16 16 16 16 16 16 16 16 16 16 2 16 16 16 16 16 16 16 16 16 16 16 16 3 16 16 16 16 16 16 16 16 16 16 16 3 3 3 3 3 3 16 16 16 16 16 16 16 16
16 16 16 16 16 16 16 16 16 16 2 16 16 16 16 16 16 16 16 16 16 16 16 3 16 16 16 16 16 16 16 16 16 16 16 16 16 16 3 16 16 16 16 16 16 16 16 16 16
16 16 16 16 16 16 16 16 16 16 2 16 16 16 16 16 16 16 16 16 16 16 16 3 16 16 16 16 16 16 16 16 16 16 16 16 16 16 3 16 16 16 16 16 16 16 16 16 16
16 16 16 16 16 16 16 16 16 16 2 16 16 16 16 16 16 16 16 16 16 16 16 3 16 16 16 16 16 16 16 16 16 16 16 16 16 16 3 16 16 16 16 16 16 16 16 16 16
16 16 16 16 16 16 16 16 2 2 2 16 16 16 16 16 16 16 16 16 16 16 16 3 16 16 16 16 16 16 16 16 16 16 16 16 16 16 3 16 16 16 16 16 16 16 16 16 16
16 16 16 16 16 16 16 16 2 16 16 16 16 16 16 16 16 16 16 16 16 16 16 3 16 16 16 16 16 16 16 16 16 16 16 16 16 16 3 16 16 16 16 16 16 16 16 16 16
16 16 16 16 16 16 16 16 2 16 16 16 16 16 16 16 16 16 16 16 16 16 2 3 2 16 16 16 16 16 16 16 16 16 16 16 3 3 3 16 16 16 16 16 16 16 16 16 16
16 16 16 16 16 16 16 16 2 16 16 16 16 16 16 16 16 16 16 16 16 2 2 3 2 2 16 16 16 16 16 16 16 16 16 16 3 16 16 16 16 16 16 16 16 16 16 16 16
16 16 16 16 16 16 16 16 2 16 16 16 16 16 16 16 16 16 16 16 2 2 2 3 2 2 2 16 16 16 16 16 16 16 16 3 3 16 16 16 16 16 16 16 16 16 16 16 16
16 16 16 16 16 16 16 16 2 16 16 16 3 3 3 3 3 3 3 3 3 3 3 3 3 3 3 3 3 3 3 3 3 3 3 3 3 16 16 16 16 16 16 16 16 16 16 16 16 16
16 16 16 16 16 16 16 16 2 16 16 16 2 16 16 16 16 16 16 16 2 2 2 3 2 2 2 16 16 16 16 16 16 16 16 16 3 16 16 16 16 16 16 16 16 16 16 16 16
16 16 16 16 16 16 16 16 2 16 16 16 2 16 16 16 16 16 16 16 16 2 2 3 2 2 16 16 16 16 16 16 16 16 16 16 3 16 16 16 16 16 16 16 16 16 16 16 16
16 16 16 16 16 16 16 16 2 16 16 16 2 16 16 16 16 16 16 16 16 2 3 2 16 16 16 16 16 16 16 16 16 16 16 16 3 16 16 16 16 16 16 16 16 16 16 16 16
16 16 16 16 16 16 16 16 2 16 16 16 2 2 2 16 16 16 16 16 16 16 16 3 16 16 16 16 16 16 16 16 16 16 16 16 3 16 16 16 16 16 16 16 16 16 16 16 16
16 16 16 16 16 16 16 16 2 16 16 16 16 16 2 16 16 16 16 16 16 16 16 3 16 16 16 16 16 16 16 16 16 16 16 16 3 16 16 16 16 16 16 16 16 16 16 16 16
16 16 16 16 16 16 16 16 2 16 16 16 16 16 2 16 16 16 16 16 16 16 16 3 16 16 16 2 16 16 16 16 16 16 16 2 3 16 16 16 16 16 16 16 16 16 16 16 16
16 16 16 16 16 16 16 16 2 16 16 16 16 16 2 16 16 16 16 16 16 16 16 3 16 16 16 16 16 16 2 16 16 16 16 16 3 16 16 16 16 16 16 16 16 16 16 16 16
16 16 16 16 16 16 16 16 2 2 2 2 2 2 2 16 16 16 16 16 16 16 16 3 16 16 16 16 16 16 2 16 16 16 16 16 3 16 16 16 16 16 16 16 16 16 16 16 16
16 16 16 16 16 16 16 16 2 2 2 2 2 2 2 16 16 16 16 16 16 16 16 3 16 16 16 16 16 16 16 16 16 16 16 16 2 16 16 16 16 16 16 16 16 16 16 16 16
16 16 16 16 16 16 16 16 2 2 2 2 2 2 2 16 16 16 16 16 16 16 16 3 16 16 16 16 16 16 16 16 16 16 16 2 2 2 16 16 16 16 16 16 16 16 16 16 16
16 16 16 16 16 16 16 16 2 2 2 2 2 2 2 16 16 16 16 16 16 16 16 3 16 16 16 16 16 16 16 16 16 16 16 2 2 2 16 16 16 16 16 16 16 16 16 16 16
16 16 16 16 16 16 16 16 2 2 2 2 2 2 2 16 16 16 16 16 16 16 16 3 16 16 16 16 16 16 16 16 16 16 16 2 2 2 16 16 16 16 16 16 16 16 16 16 16
16 16 16 16 16 16 16 16 2 2 2 2 2 2 2 16 16 16 16 16 16 16 16 3 16 16 16 16 16 16 16 16 16 16 16 2 2 2 16 16 16 16 16 16 16 16 16 16 16
16 16 16 16 16 16 16 16 16 16 16 16 16 16 16 16 16 16 16 16 16 16 16 3 16 16 16 16 16 16 16 16 16 16 16 2 2 2 16 16 16 16 16 16 16 16 16 16
16 16 16 16 16 16 16 16 16 16 16 16 16 16 16 16 16 16 16 2 2 2 2 2 2 2 2 16 16 16 16 16 16 16 2 2 2 2 2 16 16 16 16 16 16 16 16 16 16
16 16 16 16 16 16 16 16 16 16 16 16 16 16 16 16 16 16 2 2 2 2 2 2 2 2 2 2 16 16 2 16 2 2 2 2 2 2 16 16 16 16 16 16 16 16 16 16
16 16 16 16 16 16 16 16 16 16 16 16 16 16 16 16 16 16 2 2 2 2 2 2 2 2 2 2 16 16 16 16 2 2 2 2 2 2 2 16 16 16 16 16 16 16 16 16 16
16 16 16 16 16 16 16 16 16 16 16 16 16 2 16 16 16 16 2 2 2 2 2 2 2 2 2 2 2 16 16 16 2 2 2 2 2 16 2 16 16 16 16 16 16 16 16 16 16
16 16 16 16 16 16 16 16 16 16 16 16 16 16 16 16 16 16 2 2 2 2 2 2 2 2 2 2 2 2 2 2 2 2 16 2 2 2 2 16 16 16 16 16 16 16 16 16 16
16 16 16 16 16 16 16 16 16 16 16 16 16 2 16 16 16 16 16 2 2 2 2 2 2 2 2 16 16 16 16 2 2 2 2 2 2 2 2 16 16 16 16 16 16 16 16 16 16
16 16 16 16 16 16 16 16 16 16 16 16 16 16 16 16 16 16 16 16 2 2 2 2 2 2 16 16 16 16 16 2 2 16 2 2 16 2 2 16 16 16 16 16 16 16 16 16 16
16 16 16 16 16 16 16 16 16 16 16 16 16 16 16 16 16 16 16 16 16 16 16 16 16 16 16 16 16 16 16 16 2 2 2 2 2 2 16 16 16 16 16 16 16 16 16 16
16 16 16 16 16 16 16 16 16 16 16 16 16 16 16 16 16 16 16 16 16 16 16 16 16 16 16 16 16 16 16 16 16 16 16 16 16 16 16 16 16 16 16 16 16 16 16 16 16 16
16 16 16 16 16 16 16 16 16 16 16 16 16 16 16 16 16 16 16 16 16 16 16 16 16 16 16 16 16 16 16 16 16 16 16 16 16 16 16 16 16 16 16 16 16 16 16 16 16 16
16 16 16 16 16 16 16 16 16 16 16 16 16 16 16 16 16 16 16 16 16 16 16 16 16 16 16 16 16 16 16 16 16 16 16 16 16 16 16 16 16 16 16 16 16 16 16 16 16 16
16 16 16 16 16 16 16 16 16 16 16 16 16 16 16 16 16 16 16 16 16 16 16 16 16 16 16 16 16 16 16 16 16 16 16 16 16 16 16 16 16 16 16 16 16 16 16 16 16 16
16 16 16 16 16 16 16 16 16 16 16 16 16 16 16 16 16 16 16 16 16 16 16 16 16 16 16 16 16 16 16 16 16 16 16 16 16 16 16 16 16 16 16 16 16 16 16 16 16 16
16 16 16 16 16 16 16 16 16 16 16 16 16 16 16 16 16 16 16 16 16 16 16 16 16 16 16 16 16 16 16 16 16 16 16 16 16 16 16 16 16 16 16 16 16 16 16 16 16 16